15 14
####....#.....
....S.....##..
...##.........
##......######
...##.#.......
#####.........
...##.#...####
#####....#####
......#...####
.....#........
..............
......##..####
....###......#
E........#####
..............
